........
..O.....
.....X..
........
........
